myStuff
An Interactive Fiction by Akash Prasad
Release 1 / Serial number 181107 / Inform 7 build 6M62 (I6/v6.33 lib 6/12N) SD

Hopkins Hall
 Welcome to Hopkins Hall! This hall is part of the Ikeberry complex, located on the west side of the UIUC's campus. There are four floors and each floor houses around a hundred people. There is the ARC building down SOUTH. There is the Ikeberry Dining hall up NORTHWEST. There is Green Street up NORTH of Ikeberry Dining hall. There is Loomis Lab EAST of Green Street. The Apple Store also happens to be NORTH of Green Street. There is ChopStix WEST of Apple Store. There is the ARC building down SOUTH. There is the Ikeberry Dining hall up NORTHWEST. There is Green Street up NORTH of Ikeberry Dining hall. There is Loomis Lab EAST of Green Street. The Apple Store also happens to be NORTH of Green Street. There is ChopStixs WEST of Apple Store. You start off with 10 energy units and you need them to move to place to place or to perform intensive actions. Make sure you eat food to keep replenishing yourself with energy units or you die and lose the game.

 There is a closed door in SOUTH. 

You can also see a superheated T-shirt, Advanced Algebraic Topology textbook, an iPhone Xs MAX, a Surface Book 2, Rishi, Oscar and a gym key here.

>north
Sorry, you can't simply walk into the walls. There is nothing really interesting over there! Instead, you can go NORTHWEST to Ikeberry Dining Hall or SOUTH to ARC building.

The time is 9:00 am.
You now have 9 energy units left.

>south]
That's not a verb I recognise.

>south
(first opening ARC door)

ARC building
Welcome to the Activities and Recreational Center! This place offers pletora of things to do to stay active. There is a 50 meter swimming pool, weightlifting room, track turf, basketball courts, and many more (there is even a rock climbing wall!). There is a doorway to Hopkins Hall up NORTH. 

 There is a closed door up NORTH.

You can also see a Treadmill here.

The time is 9:01 am.
You now have 8 energy units left.

>north
Hopkins Hall

 There is a closed door in SOUTH. 

You can also see Advanced Algebraic Topology textbook, an iPhone Xs MAX, a Surface Book 2, Rishi, Oscar and a gym key here.

The time is 9:02 am.
You now have 7 energy units left.

>northwest
Ikeberry Dining Hall
 Welcome to the Ikeberry Dining Hall! This place contains the largest dining hall on campus! In addition, there is the ikeberry library to study and there are some cafe shops like Caffinator and 57 North, were you can grab a quick bite and refuel yourself with coffee. There is a doorway to Green Street up NORTH and Hopkins Hall down SOUTHEAST. 

You can see a Pizza, a raw egg yolk, an Unsweetened Iced Tea, a milk and a coffee here.

The time is 9:03 am.
You now have 6 energy units left.

>eat pizza
Congradulations! Now you have ingested 300 calories!
You now have 7 energy units.

The time is 9:04 am.
You now have 6 energy units left.

* * *

>northwest
Ikeberry Dining Hall
 Welcome to the Ikeberry Dining Hall! This place contains the largest dining hall on campus! In addition, there is the ikeberry library to study and there are some cafe shops like Caffinator and 57 North, were you can grab a quick bite and refuel yourself with coffee. There is a doorway to Green Street up NORTH and Hopkins Hall down SOUTHEAST. 

You can see a Pizza, a raw egg yolk, an Unsweetened Iced Tea, a milk and a coffee here.

The time is 9:00 am.
You now have 9 energy units left.

>eat pizza
Congradulations! Now you have ingested 300 calories!
You now have 11 energy units.

The time is 9:01 am.
You now have 10 energy units left.

>north
Green Street
 Welcome to Green Street! This downtown Champaign is were there is plenty of restaurants and coffeeshops to choose from, next to some of the tallest buildings in town. A great place to spend a weekend night with friends. There is a dorrway to Ikeberry Dining Hall down SOUTH. The Apple Store also happens to be NORTH of Green Street. 

You can see a group of friends and a Panda Express (empty) here.

The time is 9:02 am.
You now have 9 energy units left.

>north
Cornfield1
The Apple store is in Chicago and you are in the middle of nowhere. You have to pass through various Cornfields by going futher north.

The time is 9:03 am.
You now have 8 energy units left.

>north
Cornfield2
Keep going!

The time is 9:04 am.
You now have 7 energy units left.

>north
Cornfield3
Keep going!

The time is 9:05 am.
You now have 6 energy units left.

>north
Cornfield4
Almost there...

The time is 9:06 am.
You now have 5 energy units left.

>norht
That's not a verb I recognise.

>northj
That's not a verb I recognise.

>north
Apple Store
 You have finally made it! Here, there is various apple products you can see and demo on. There are iPhones, iPads, Apple Watches, Apple TVs and Macs. There are various accessories such as HomePods, BeatsSolo, etc. Please come try all of them out and purchase if you like it! 

The time is 9:07 am.
You now have 4 energy units left.

>examine iPhone
You can't see any such thing.

>north
You can't go that way.

The time is 9:08 am.
You now have 3 energy units left.

>north]
That's not a verb I recognise.

>north
You can't go that way.

Hey! You are running out of energy, go to the nearest food place to replenish your energy units.

The time is 9:09 am.
You now have 2 energy units left.

>norht
That's not a verb I recognise.

>north
You can't go that way.

The time is 9:10 am.
You now have 1 energy units left.

>north
You can't go that way.

The time is 9:11 am.
You now have 0 energy units left.

>north
You can't go that way.

    *** You ran out of energy units. You have died. Game over. ***

In that game you scored 0 out of a possible 0, in 13 turns.

Would you like to RESTART, RESTORE a saved game, QUIT or UNDO the last command?

* * *

>interrogate Rishi
That's not a verb I recognise.

>ask rishi
What do you want to ask Rishi about?