GCL143 - Project 1
An Interactive Fiction by Sumuk Rao
Release 1 / Serial number 181211 / Inform 7 build 6M62 (I6/v6.33 lib 6/12N) SD

front porch
You look up at the imposing brick building in wonder. The east side of the building is shaded by tall, sturdy oak trees. The building is tall and imposing, with four stories. Windows allow you to peer into the building. You can see a woman sewing in a cozy looking armchair, and you avert your eyes to avoid being improper towards a lady. You walk towards the front door, and stand under the eaves, pausing before knocking on the wooden door. (go inside to enter the Hull House)

You can see now the player, tree, windows, random lady, front door, door handle, blouse and street here.

>talk to random lady
I'm busy! I'm bringing these to Ms. Starr.

>go inside
foyer
You walk into the foyer, stepping onto a pretty red rug. You can see a parlor to the EAST. The wooden floorboards creak beneath your feet, and a woman turns to face you.

You can see Mary Kenney O'Sullivan, rug and floorboards here.

* * *

>hello
Oh, hello.
That's not a verb I recognise.

>where is jane addams
Jane? Oh, I think she's in the parlor, somewhere.
That's not a verb I recognise.

>who are you
I am Mary O'Sullivan. Maybe you've heard of me? I, and some other women, are working hard for workers" rights.
That's not a verb I recognise.

>go eat
You can't see any such thing.

>go east
parlor
You wander into the parlor, and see a square table and a few chairs nestled around it. The light blue walls and cream-colored curtains make the room feel bright and inviting. The carpet beneath your feet is comfortable, and you can feel warmth emitting from the roaring fire.

You can see Ellen Gates Starr, parlor table, chairs, fireplace, carpet and curtains here.

* * *

>hi
Hello. Are you looking for someone?
That's not a verb I recognise.

>who are you
Me? I am Ellen Gates Starr, co-founder of Hull House.
That's not a verb I recognise.

>where is jane addams
Hmmm, I'm not sure where Ms. Addams is right now. You should try her study. Which is to the west.
That's not a verb I recognise.

>go west
study
You step into Jane's dimly lit study. It smells strongly of wood and paper and there is a gentle crackling coming from the fire. There is a large window over Jane's wooden desk, but little sunlight is shining through. Piles and piles of papers and books line her desk. Jane is sitting in a soft chair facing the fire, gripping a letter, and she turns to face you when she hears you come in.

You can see Jane Addams, bookshelf, books, desk, papers, chair and fire here.

* * *

>Hi
Hello. Are you looking for someone?
That's not a verb I recognise.

>hello
That's not a verb I recognise.

* * *

>Hi
Hello. Are you looking for someone?
That's not a verb I recognise.

>Hi
Hello. Are you looking for someone?
That's not a verb I recognise.

>stop talking to Ellen Gates Starr
That's not a verb I recognise.

* * *

>go inside
foyer
You walk into the foyer, stepping onto a pretty red rug. You can see a parlor to the EAST. The wooden floorboards creak beneath your feet, and a woman turns to face you.

You can see Mary Kenney O'Sullivan, rug and floorboards here.

>talk to Mary Kenney O'Sullivan
How can I help? 
 Say a) Hi b) Who are you c) Where is Jane

* * *

>go inside
foyer
You walk into the foyer, stepping onto a pretty red rug. You can see a parlor to the EAST. The wooden floorboards creak beneath your feet, and a woman turns to face you.

You can see Mary Kenney O'Sullivan, rug and floorboards here.

>talk to Mary
How can I help? 
 Say a) Hi b) Who are you c) Where is Jane

>hi
Oh, hello.

>who are you
I am Mary O'Sullivan. Maybe you've heard of me? I, and some other women, are working hard for workers" rights.

>where is jane
Jane? Oh, I think she's in the parlor, somewhere.

>go east
parlor
You wander into the parlor, and see a square table and a few chairs nestled around it. The light blue walls and cream-colored curtains make the room feel bright and inviting. The carpet beneath your feet is comfortable, and you can feel warmth emitting from the roaring fire.

You can see Ellen Gates Starr, parlor table, chairs, fireplace, carpet and curtains here.

>talk to ellen
How can I help? 
 Say a) Hi b) Who are you c) Where is Jane

>hi
Hello. Are you looking for someone?

* * *

>go inside
foyer
You walk into the foyer, stepping onto a pretty red rug. You can see a parlor to the EAST. The wooden floorboards creak beneath your feet, and a woman turns to face you.

You can see Mary Kenney O'Sullivan, rug and floorboards here.

>talk to mary
How can I help? 
 Say a) Hi b) Who are you c) Where is Jane

>hi
Oh, hello.